1111111111111D1111111111
100000000000000000000001
10000000000S00000000000D
10000000000000000000M001
111111111111111111111111

