NO ./texture/wall.xpm
SO ./texture/wall.xpm
WE ./texture/wall.xpm
EA ./texture/wall.xpm

F 54,100,125
C 100,60,40

111111111111111111111111
100000000100000000000001
10000000010H000000000001
100000000100000000000001
1000000001000000M0000001
100000000100000000000001
10000R0001111D1100000001
100000000000M001000M0001
1000000000000001M0000001
111111L111111111111D1111
100010000000100000000001
1000100000001000000H0001
1G0010000000100000000001
11D110000000100000000001
100000000000100000000001
100000000000100000000001
100000000000100000000001
1000000S0000100000000001
111111111111111111111111
