1111111111111D1111111111
100000000000000000000001
10000000000E0000M000000D
100000000000000000000001
111111111111111111111111

