11111111111111111111111
10000000010000000000001
10000000010000000000001
10000000010000000000001
10000000010000000000001
10000000010000000000001
10000R0001111D110000001
10000000000000010000001
10000000000000010000001
111111L111111111111D1111
100010000000100000000001
100010000000100000000001
1G0010000000100000000001
11D11000H000100000000001
100000000M00100000000001
1000000H0R00100000000001
100000000000100000000001
1000000S0000100000000001
111111111111111111111111
