111111111111111111111111
100000000000000000000001
10000000000S000000000001
100000000000000000000001
100000000000000000000001
100000000000000000000001
100000MMMMMMM00000000001
100000000000000000000001
100000000000000000000001
100000000000000000000001
100111111111111111111111
100000000000000000000001
10000000000000000M000001
10000000000M000000000001
100000000000000000000001
10000000000M000000000001
100000000000000000000001
100000000000M00000000001
100000000000000000000001
100000000000000000000001
111111111111111111111111
