F 0,100,0
C 25,25,25

NO ./texture/wall.xpm
SO ./texture/wall.xpm
WE ./texture/wall.xpm
EA ./texture/wall.xpm

111111111111111111111111
100000000100000000000001
100000000100000000000001
100000000100000000000001
100000000100000000000001
100000000100000000000001
10000R0001111D1100000001
100000000000000100000001
100000000000000100000001
111111L111111111111D1111
100010000000100000000001
100010000000100000000001
1G0010000000100000000001
11D11000H00010000000000111
100MMM000M00100000000001
1000000H0R00100000000001
10000000000010000000000111
10000000000010000000000001
10000000011111111000000000111
10000N0001       100000000001
1111111111       100000000001
                 111111111111