NO ./texture/wall.xpm
SO ./texture/wall.xpm
WE ./texture/wall.xpm
EA ./texture/wall.xpm

F 0,100,0
C 25,25,25

111111111111
1G00R00100H1
1000000L00HM1
10000N0100M1
1000000100M1
111111111111
